15
000000000000000
031102020202020
012202222222220
022222222222220
022222222222220
022222222222220
022222000222220
022222222222220
022222222222220
022200222222220
022202222222220
022222222222220
010222222222010
011222222222110
000000000000000
