15
000000000000000
035111111111110
010101010101010
011111111111110
011111111111110
011151111111110
011111111111110
011111111111110
011111111111110
011111111111110
011111111111110
011111111111110
011111111111110
011111111111110
000000000000000