15
000000000000000
011102020202020
011102222222220
011122222222220
022222222222220
022222222222220
022222000222220
022222222222220
022222222222220
022200222222220
022202222222220
022222222222010
010222222221010
011222222211110
000000000000000
