15
000000000000000
035111111111110
010101010101010
011111111111110
011111999111110
011151111111110
011111111111110
011116171111110
011111111111110
011111111111110
011111911111110
011111111951110
011111111111110
011111111111110
000000000000000