15
000000000000000
035111111111110
010101010101010
011111111111110
011111555111110
011151111111110
011111111111110
011116166661110
011111111111110
011111111111110
011111411111110
011111111451110
011111111111110
011111111111110
000000000000000