16
0000000000000000
0111222111111110
0110011111111110
0110111111111110
0111111111111110
0111122211111110
0111122211111110
0111122211111110
0111111111111110
0111111111111110
0111111111111110
0111111100011110
0111111111111110
0111011111111110
0111111111111110
0000000000000000